"filename", "language", "C++", "comment", "blank", "total"
"c:\Users\awbmilne\Documents\School\2022 Fall\ME 380 - Mechanical Engineering Design Workshop\Project\ME380-Pick-and-Place\src\Control\AutoCycle.h", "C++", 140, 50, 28, 218
"c:\Users\awbmilne\Documents\School\2022 Fall\ME 380 - Mechanical Engineering Design Workshop\Project\ME380-Pick-and-Place\src\Control\AutoCycleState.h", "C++", 25, 8, 4, 37
"c:\Users\awbmilne\Documents\School\2022 Fall\ME 380 - Mechanical Engineering Design Workshop\Project\ME380-Pick-and-Place\src\Control\Calibration.h", "C++", 64, 19, 14, 97
"c:\Users\awbmilne\Documents\School\2022 Fall\ME 380 - Mechanical Engineering Design Workshop\Project\ME380-Pick-and-Place\src\Control\CalibrationState.h", "C++", 10, 8, 4, 22
"c:\Users\awbmilne\Documents\School\2022 Fall\ME 380 - Mechanical Engineering Design Workshop\Project\ME380-Pick-and-Place\src\Control\CommandParsing.h", "C++", 172, 29, 15, 216
"c:\Users\awbmilne\Documents\School\2022 Fall\ME 380 - Mechanical Engineering Design Workshop\Project\ME380-Pick-and-Place\src\Control\ReturnHome.h", "C++", 50, 20, 13, 83
"c:\Users\awbmilne\Documents\School\2022 Fall\ME 380 - Mechanical Engineering Design Workshop\Project\ME380-Pick-and-Place\src\Control\ReturnHomeState.h", "C++", 11, 8, 4, 23
"c:\Users\awbmilne\Documents\School\2022 Fall\ME 380 - Mechanical Engineering Design Workshop\Project\ME380-Pick-and-Place\src\Control\SystemState.h", "C++", 11, 8, 3, 22
"c:\Users\awbmilne\Documents\School\2022 Fall\ME 380 - Mechanical Engineering Design Workshop\Project\ME380-Pick-and-Place\src\Inputs\Inputs.h", "C++", 11, 4, 3, 18
"c:\Users\awbmilne\Documents\School\2022 Fall\ME 380 - Mechanical Engineering Design Workshop\Project\ME380-Pick-and-Place\src\Inputs\LimitSwitch.h", "C++", 34, 12, 9, 55
"c:\Users\awbmilne\Documents\School\2022 Fall\ME 380 - Mechanical Engineering Design Workshop\Project\ME380-Pick-and-Place\src\Inputs\Sensor.cpp", "C++", 32, 20, 6, 58
"c:\Users\awbmilne\Documents\School\2022 Fall\ME 380 - Mechanical Engineering Design Workshop\Project\ME380-Pick-and-Place\src\Inputs\Sensor.h", "C++", 16, 0, 4, 20
"c:\Users\awbmilne\Documents\School\2022 Fall\ME 380 - Mechanical Engineering Design Workshop\Project\ME380-Pick-and-Place\src\Outputs\GranularControl.cpp", "C++", 53, 33, 10, 96
"c:\Users\awbmilne\Documents\School\2022 Fall\ME 380 - Mechanical Engineering Design Workshop\Project\ME380-Pick-and-Place\src\Outputs\GranularControl.h", "C++", 28, 4, 6, 38
"c:\Users\awbmilne\Documents\School\2022 Fall\ME 380 - Mechanical Engineering Design Workshop\Project\ME380-Pick-and-Place\src\Outputs\GranularServo.cpp", "C++", 91, 70, 18, 179
"c:\Users\awbmilne\Documents\School\2022 Fall\ME 380 - Mechanical Engineering Design Workshop\Project\ME380-Pick-and-Place\src\Outputs\GranularServo.h", "C++", 85, 20, 11, 116
"c:\Users\awbmilne\Documents\School\2022 Fall\ME 380 - Mechanical Engineering Design Workshop\Project\ME380-Pick-and-Place\src\Outputs\GranularStepper.cpp", "C++", 86, 115, 24, 225
"c:\Users\awbmilne\Documents\School\2022 Fall\ME 380 - Mechanical Engineering Design Workshop\Project\ME380-Pick-and-Place\src\Outputs\GranularStepper.h", "C++", 79, 5, 11, 95
"c:\Users\awbmilne\Documents\School\2022 Fall\ME 380 - Mechanical Engineering Design Workshop\Project\ME380-Pick-and-Place\src\Outputs\LedControl.h", "C++", 21, 5, 11, 37
"c:\Users\awbmilne\Documents\School\2022 Fall\ME 380 - Mechanical Engineering Design Workshop\Project\ME380-Pick-and-Place\src\Outputs\Outputs.h", "C++", 51, 12, 5, 68
"c:\Users\awbmilne\Documents\School\2022 Fall\ME 380 - Mechanical Engineering Design Workshop\Project\ME380-Pick-and-Place\src\config.h", "C++", 56, 4, 8, 68
"c:\Users\awbmilne\Documents\School\2022 Fall\ME 380 - Mechanical Engineering Design Workshop\Project\ME380-Pick-and-Place\src\main.cpp", "C++", 40, 5, 10, 55
"c:\Users\awbmilne\Documents\School\2022 Fall\ME 380 - Mechanical Engineering Design Workshop\Project\ME380-Pick-and-Place\src\utilities.h", "C++", 7, 1, 2, 10
"Total", "-", 1173, 460, 223, 1856